********
***A****
********
S**O*CR*
********
**W*****
