****P***
**W*****
S*W**W*R
**W*****
****P***


