******A*
S*W*****
*****P**
********
***W*CR*
********
