***A****
***C****
S*P*****
****C*R*
********
********
